
        wwwwwwwwwwwwwwwwwwww
        w                  w
        w                  w
        w                  w
        w         p        w
        w                  w
        w                  w
        w                  w
        w                  w
        wwwwwwwww  wwwwwwwww
        w       w    w     w